0 2 2 2 2 2 2 2 2 2 2 2 2 2 2 2 2 2 2 2 2 2 2 2 2 2 2 2 2 2 2 4 3 3 3 3 3 3 3 3 3 3 3 3 3 3 3 3 3 3 3 3 3
0 0 0 0 0 0 0 0 0 0 0 0 0 0 0 0 0 0 0 0 0 0 0 0 0 0 0 1 1 1 4 9 4 4 9 4 4 4 4 4 4 4 4 4 4 4 4 4 4 4 4 4 4
0 0 0 0 0 0 0 0 0 0 0 0 0 0 0 0 0 0 0 0 0 0 0 0 0 0 0 1 1 1 2 9 4 4 9 4 4 4 0 1 1 1 4 4 4 4 4 4 4 4 4 4 4
2 2 2 2 2 2 0 0 2 2 2 2 2 0 0 2 0 0 0 0 0 0 0 0 0 0 0 1 1 1 2 9 4 4 0 0 0 0 0 4 4 1 1 1 4 4 4 4 4 4 4 4 4
0 0 0 0 0 2 0 0 2 0 0 0 2 0 0 2 0 0 0 0 0 0 0 0 0 0 0 1 1 1 2 9 4 4 9 0 0 4 4 4 4 4 4 2 4 4 4 4 4 4 4 4 4
0 0 0 0 0 2 0 0 2 0 2 0 2 0 0 2 0 0 0 0 0 0 0 0 0 0 0 1 1 1 4 9 4 4 0 0 4 0 0 0 0 0 0 0 0 4 4 4 4 4 4 4 4
0 0 0 0 0 2 0 0 2 0 2 0 2 0 0 2 0 0 0 0 0 0 0 0 0 0 0 1 1 1 2 3 4 4 9 4 4 0 4 4 4 4 4 4 4 2 2 4 4 3 4 4 4
2 2 2 2 2 2 0 0 2 0 0 0 2 0 0 2 0 0 0 0 0 0 0 0 0 0 0 1 1 1 2 9 4 4 9 4 4 0 4 4 4 4 4 4 4 2 2 2 2 2 4 4 4
2 0 0 0 0 0 0 0 2 0 2 2 2 0 0 4 0 0 0 0 0 0 0 0 0 0 0 1 1 1 2 9 4 4 0 0 0 0 0 0 0 4 4 4 4 4 4 2 4 4 4 4 4 
2 0 0 0 0 0 0 0 2 0 0 0 0 0 0 4 0 0 0 0 0 0 0 0 0 0 0 1 1 1 2 9 4 4 9 0 0 4 4 4 1 1 1 1 1 1 1 1 4 4 4 4 4 
2 2 2 2 2 2 2 2 2 2 2 2 2 0 0 0 0 0 0 0 0 0 0 0 0 0 1 1 1 2 9 4 4 4 9 0 0 4 4 4 4 4 4 1 4 1 4 4 4 4 4 4 4
2 0 0 0 0 0 0 0 0 0 0 0 0 2 0 2 0 0 0 0 0 0 0 0 0 0 0 1 1 1 2 9 4 4 0 0 0 4 4 3 2 4 4 1 4 1 1 4 4 4 4 4 4 
2 1 1 0 0 0 0 0 0 0 0 0 0 0 0 2 0 0 0 0 0 0 0 0 0 0 0 1 1 1 2 9 4 4 9 4 4 4 4 4 2 2 2 1 4 1 1 1 1 4 4 4 4 
2 2 2 2 2 0 2 2 2 2 2 2 2 2 2 0 0 0 0 0 0 0 0 0 0 0 0 1 1 1 2 3 4 4 9 4 4 4 4 4 4 4 4 4 4 4 4 4 4 4 4 4 4
2 2 2 2 2 2 2 2 2 2 2 2 2 2 2 2 2 2 2 2 2 2 2 2 2 2 2 2 2 2 9 9 3 3 3 3 3 3 3 3 3 3 3 3 3 3 3 3 3 3 3 3 3
0 0 0 0 0 0 0 0 0 0 0 0 0 0 0 0 0 0 0 0 0 0 0 0 0 0 0 0 0 0 0 5 0 0 0 5 5 5 5 5 5 5 5 5 5 5 5 5 5 5 5 5 5
